ллллллллллллллллллллллллллллллллллллллллллллллллллллллллллллллллллллллллллллл
ллллллллллллллллллллллллллллллллллллллллллллллллллллллллллллллллллллллллллллл
л                                                                           л
л                                                                           л
л                                                                           л
л                                                                           л
л                                                                           л
л                                                                          л
л                                                                           л
л                                                                           л
л                                                                          л
л                                                                           л
л                                                                           л
л                                                                           л
ллллл                                                                       л
л                                                                          л
ллллл                                                                       л
л                                                                           л
л                                                                           л
л                                                                           л
ллллллллллллллллллллллллллллллллллллллллллллллллллллллллллллллллллллллллллллл
